1111111111111
1E110C00C0001
1000P01011001
10C011C001C01
10C011C001C01
10C011C001C01
10C011C001C01
10C011C001C01
10C011C001C01
1111111111111
