1111111111111
10110C00C0001
1000000011001
10C011CC01C01
100011C001C01
10C000C000C01
100001C001C01
1000100C01C01
1P0001C000C01
1111111111111