1111111111111
1E11000000001
1000000011001
1000110001001
1000110001001
1000000000001
1000010001001
1000100001001
1P00010000001
1111111111111