111111111111111111111
1ECCCCCCCCCCCCCCCCCP1
111111111111111111111